timer 250
timerfantome 20  

CCCCCCCCCCCCCCCCCCCCC  
C E   C C C C C   E C  
C M M   M M M M M M C  
CMCMCM MCMCMCMCMCCM C  
CMMM   MMMMMMMMMMMM C  
C CMCMCMCMCMCMCMMCM C  
C MMMMMMMMMMMMMMMMM C  
C CMCMCMCMCMCMCMCMC C  
CE  MMMMM   U   MMM C  
C CMCMCMCMCM P CMCM C  
C MM   MMMMMMMMMMMM C  
CCCMC CMCMCMCMCMCMC C  
C MMMMMMMMMMMMMMMMM C  
CMCMCMCMCMCMCMCMCMC C  
C MMMMMMMMMMMMMMMMM C  
CCCMCMCMCMCMCMCMCMC C  
CMM M M M M M M M M C  
CEMMMMC C CEC C   E C  
CCCCCCCCCCCCCCCCCCCCC  
